Adam: Adam Warlock, Frankenstein Monster
Alan: Alan Bradley, Alan Grant, Alan Scott, Alan Wake
Alex: Alex (Minecraft), Alex DeLarge, Alex Fierro, Alex Vogel, Alex
Alice: Alice Daerdahk, Alice Johnson
Amy: Amethyst, Amy Cahill, Amy Rose
Anakin: Anakin Skywalker (Young), Anakin Skywalker, Darth Vader
Anna: Anna Croft, Anna
Victor: Anole, Cyborg, Victor Frankenstein
Arthur: Aquaman, Arthur Holmwood, Arthur Weasley, Drax the Destroyer
Ashley: Ashley Brown, Ashley Williams
Atsuhiro: Atsuhiro Sako, Kurogiri
Barry: Barry Allen, Barry B. Benson, Barry Wheeler
Bruce: Batman, Bruce Ng
Bill: Bill Cipher, Bill Kerman, Bill Weasley
Billy: Billy Pilgrim, Captain Marvel
Michael: Booster Gold, Michael Myers
Bowser: Bowser Jr., Bowser
Brian: Brian Robeson, Captain Britain
James: Bucky Barnes, Captain Kirk, Doomslayer, James Moriarty, Jim Gordon, War Machine, Wolverine
Calypso: Calypso (The Odyssey), Calypso
Sam: Cannonball, Sam (Sam and Fuzzy), Sam (Stardew Valley)
Steve: Captain America, Steve (Minecraft)
John: Captain John H. Miller, John Proudstar, John Seward, John Stewart, John Watson
Carter: Carter Kane, Sadie Kane
Scott: Cyclops, Scott Lang, Young Cyclops
Nilox: Deag Grav, Deag Nilox
Samuel: Dr. Loomis, Dr. Samuel Hayden, Falcon, Sam Alexander
Hunter: Emperor Belos, Hunter
Frisk: Frisk (Genocide Route), Frisk (Neutral Route), Frisk (Pacifist Route), Frisk
Rose: Gran'ma Ben, Rose Tico
William: Guile, Maxwell, William Cage
Han: Han Solo (Old), Han Solo
Harrison: Harrison Truscott (Evil), Harrison Truscott
Harry: Harry Lyme, Harry Potter
Robert: Hulk, Mr. Incredible
Iris: Irey West, Iris West
Jason: Jason Grace, Jason Todd
Jonathan: Jonathan Harker, The Human Torch
Kal: Kal-L, Superboy Prime, Superman
Ken: Ken Ishiyama, Ken
King: King Clawthorne, King
Leia: Leia Organa (Old), Leia Organa
Luke: Luke Castellan, Luke Skywalker
Thomas: Neo, Thomas Jefferson Jr.
Steven: Pearl, Steven Universe
Ruby: Ruby Rider, Ruby Rose, Ruby
Sebastian: Sebastian Polge, Sebastian
Peter: Spider-Man, Star-Lord
Wallace: Wally West II, Wally West
Yekkon: Yekkon Shmalakis, Yekkon Shmekkon
