: Aigis, Makoto Yuki
1917: Lance Corporal Thomas Blake, Lance Corporal William Schofield
39 Clues: Amy Cahill, Dan Cahill
A Clockwork Orange: Alex DeLarge
A Nightmare on Elm Street: Alice Johnson, Freddy Krueger, Nancy Thompson
Alan Wake: Alan Wake, Barry Wheeler, Mr. Scratch
Alien: Ellen Ripley
Animal Crossing: Isabelle, Mr. Resetti, Tom Nook
Arms: Helix, Max Brass, Min-Min, Ninjara, Spring-Man, Twintelle
Assassins Creed: Desmond Miles, Ezio Auditore da Firenze
At Dead of Night: Jimmy Hall
Atlantis: The Lost Empire: Audrey Ramirez, Cookie Farnsworth, Gaetan Moliere, Joshua Sweet, Kida Nedakh, Milo Thatch, Vincenzo Santorini
Avatar: Jake Sully, Neytiri
Avatar: The Last Airbender: Aang, Azula, Iroh, Katara, Mai, Ozai, Sokka, Suki, Toph Beifong, Ty Lee, Zuko
Avengers: Thanos
Band of Fools: Deux, Red (Band of Fools), Sheebo Leafellow, Vondal Metalbender
Band of Fools Original: Akkar, Arthail Consumer of Food, Byllemura Ruby-Eye, Glynnric Manassnass, Kalathos Sunstrider, Kareem Par-Al, Nahara, Ruby Rider
Band of Fools Reboot: Arthas Menethil, Cliff Steelspike, Cody Briggs, Eldon Spark Turen, Elias Stork, Eva Turthin, Experiment-01, Fen'Sthern, Frothen Threewords, Jenifer Sternstell, Squee
Banjo & Kazooie: Banjo, Kazooie
Bayonetta: Bayonetta
Blade Runner: Leon Kowalski, Officer K, Pris Stratton, Rachael Tyrell, Rick Deckard, Roy Batty, Zhora Salome
Blood Meridian: John Glanton, Judge Holden, The kid
Bone: Blue Stupid Rat Creature, Brown Stupid Rat Creature, Fone Bone, Gran'ma Ben, Phoney Bone, Smiley Bone, Thorn Harvestar
Borderlands: Fiona, FL4K, Gaige, Gortys, Handsome Jack, Krieg, Lady Aurelia Hammerlock, Lilith, Maya, Mordecai, Moze, Nisha Kadam, Rhys, Roland, Salvador, Sasha, Timothy, Vaughn, Wilhelm, Zane, Zer0
Borderlands 1: Brick
Borderlands 2: Axton
Borderlands 3: Amara
Carebears: Funshine Bear, Grumpy Bear, Tenderheart Bear
Carmen Sandeigo: Carmen Sandeigo, Ivy, Player, Shadowsan, Zack
Castlevania: Alucard, Richter Belmont, Simon Belmont, Trevor Belmont
Curse of Strahd: Count Strahd von Zarovich, Ireena Kolyana, Mordenkainen, Rudolph van Richten
DC Comics: Alan Scott, Alexander Luthor Jr., Alfred Pennyworth, Amethyst, Anti-Monitor, Aquaman, Barbara Gordon, Barry Allen, Bart Allen, Batman, Beast Boy, Black Canary, Black Lightning, Booster Gold, Brainiac 5, Captain Marvel Jr., Captain Marvel, Cosmic Boy, Cyborg, Cyclone, Damian Wayne, Detective Chimp, Dick Grayson, Donna Troy, Dr. Fate, Elasti-Girl, Green Arrow, Hal Jordan, Harbringer, Hawkgirl, Hawkman, Iris West, Jade, Jakeem Thunder, Jason Todd, Jay Garrick, Jesse Quick, Jessica Cruz, Jim Gordon, John Constantine, John Stewart, Johnathan Kent, Johnny Thunder, Kal-L, Kara Zor-El, Kilowog, Kyle Rayner, Lightning Lad, Ma Hunkel, Martian Manhunter, Mary Marvel, Max Mercury, Mera, Mr. Terrific, Negative Man, Obsidean, Pariah, Power Girl, Raven, Red Tornado, Robotman, Roy Harper, Saturn Girl, Simon Baz, Starfire, Stargirl, Superboy Prime, Superboy, Supergirl, Superman, Swamp Thing, Ted Grant, Ted Kord, Tempest, The Chief, Tim Drake, Wally West II, Wally West, Wonder Girl, Wonder Woman, Zatanna
Da Vinci Code: Robert Langdon, Sophie Neveu Saint-Clair
Dark Souls: Darkeater Midir, Seath the Scaleless
Dead Space: Isaac Clarke
Detroit Become Human: Connor, Kara, Markus
Devil May Cry: Lucia, Vergil
Dishonored: Corvo Attano
Divine Comedy: Dante, Virgil
Don't Starve: Maxwell, Wigfrid, Willow, Wilson, Wormwood
Donkey Kong: Diddy Kong, Donkey Kong, King K. Rool
Doom Franchise: Doom Guy
Door Monster: Extortionist Hobo, Rodriguez ElCazorro
Dracula: Abraham Van Helsing, Arthur Holmwood, Count Dracula, Dracula, John Seward, Jonathan Harker, Lucy Westenra, Mina Harker, Quincey Morris, Renfield
Earthbound: Lucas, Ness
Edge of Tomorrow: Dr. Noah Carter, Major William Cage, Master Sergeant Farell, Sergeant Rita Vrataski
Ender's Game: Bean, Ender Wiggin, Mazer Rackham, Peter, Petra, Valentine
Eragon: Arya, Brom, Eragon, Murgath, Nasuada, Orik, Roran, Saphira, Thorn
Eureka: Allison Blake, Douglas Fargo, Henry Deacon, Jack Carter, Jim Taggart, Jo Lupo, Nathan Stark, Vincent
F-Zero: Captain Falcon
Fallen Order: Cal Kestis, Cere Junda, Greez Dritus, Merrin, Prauf
Fans!: Ally, Katherine, Rikk, Rumy, Shanna, Tim, Will
Fantastic Beasts and Where to Find Them: Newt Scamander, Tina Goldstein
Fatal Fury: Terry Bogard
Final Fantasy VII: Aerith Gainsborough, Barret Wallace, Cid Highwind, Cloud Strife, Sephiroth, Tifa Lockhart, Vincent Valentine, Yuffie Kisaragi
Fire Emblem: Chrom, Corrin, Ike, Lucina, Marth, Robin, Roy
Fire Emblem: Three Houses: Alois, Annette, Ashe, Bernadetta, Byleth, Caspar, Catherine, Claude, Dedue, Dimitri, Dorothea, Edelgard, Felix, Ferdinand, Flayn, Hilda, Hubert, Ignatz, Ingrid, Leonie, Lindhardt, Lorenz, Lysithea, Marianne, Mercedes, Raphael, Rhea, Seteth, Shamir, Sothis, Sylvain
Frankenstein: Captain Robert Walton, Frankenstein's monster, Victor Frankenstein
Frozen: Anna, Elsa, Kristoff, Oaken, Olaf, Sven
GTA V: Franklin Clinton, Michael De Santa, Trevor Philips
Game & Watch: Mr. Game and Watch
Game of Thrones: Daenerys Targaryen, Jon, Ned, Petyr, Tyrion
Ghost of Tsushima: Jin Sakai, Kenji, Lady Masako Adachi, Norio, Sensei Ishikawa, Taka, Yuna
God of War: Athena, Atreus, Kratos
Green Hell Game: Jake Higgins
Hades: Hades
Half-Life: Alyx, G-Man, Gordon Freeman
Halo: Master Chief
Harry Potter: Albus Dumbledore, Arthur Weasley, Bill Weasley, Cedric Diggory, Charlie Wealey, Dobby, Draco Malfoy, Dudley Dursley, Filius Flitwick, Fleur Delacour, Fred Weasley, George Weasley, Gilderoy Lockhart, Ginny Weasley, Godric Gryffindor, Harry Potter, Hedwig, Helga Hufflepuff, Hermione Granger, James Potter, Kingsley Shacklebolt, Lee Jordan, Lily Potter, Lord Voldemort, Luna Lovegood, Mad-Eye Moody, Minerva McGonagall, Moaning Myrtle, Molly Weasley, Neville Longbottom, Nymphadora Tonks, Oliver Wood, Percy Weasley, Pomona Sprout, Remus Lupin, Ron Weasley, Rowena Ravenclaw, Rubeus Hagrid, Severus Snape, Sirius Black, Viktor Krum
Hatchet: Brian Robeson
Hollow Knight: Hornet, the Knight
Horizon Zero Dawn: Aloy
Ice Climbers: Nana, Popo
In the Heart of the Sea: Captain George Pollard Jr., Owen Chase, Thomas Nickerson
Indiana Jones: Henry Jones, Sr., Indiana Jones, Marion Ravenwood, Sallah Mohammed Faisel el-Kahir
It's Walky: Jason Chesterfield, Joyce Brown, Mike Warner, Robin DeSanto, Sal Walkerton, the Head Alien, Walky Walkerton
James Bond: James Bond
JoJo's Bizarre Adventure: Dio Brando, Giorno Giovanna, Joseph Joestar, Josuke Higashikata, Jotaro Kujo, Koichi Hirose, Okuyasu Nijimura
JoJo's Bizarre Adventure: Battle Tendency: Caesar Anthonio Zeppeli
Journey to the West: Pigsy, Sandy, Sun Wukong, Tripitaka
Jumanji: Dr. Xander Bravestone, Mouse Finbar, Professor Sheldon Oberon, Ruby Roundhouse
Jurassic Park: Dr. Alan Grant, Dr. Ellie Sattler, Dr. Ian Malcolm, John Hammond
Kane Chronicles: Amos Kane, Carter Kane, Sadie Kane, Walt Stone, Zia Rashid
Kerbal Space Program: Bill Kerman, Bob Kerman, Jebediah Kerman, Valentina Kerman
Kid Icarus: Palutena, Pit
Kindred: Dana Franklin
Kirby: King Dedede, Kirby, Meta Knight
League of Legends: Aphelios, Darius, Draven, Elise, Fizz, Gangplank, Heimer, Miss Fortune, Soraka, Twisted Fate, Vi, Zoe
Lilo and Stitch: Cobra Bubbles, Jumba Jookiba, Lilo Pelekai, Pleakley, Stitch
Lord of the Rings: Aragorn, Arwen, Boromir, Frodo Baggins, Gandalf, Gimli, Legolas, Merry Brandybuck, Pippin Took, Samwise Gamgee, Thorin Oakenshield
Luigi's Mansion: Professor E. Gadd
MCU: Baron Zemo
Magic: The Gathering: Araithia Shokta, Chandra Nalaar, Gideon Jura, Jace Beleren, Kaya, Liliana Vess, Nicol Bolas, Teyo Verada
Magnus Chase: Alex Fierro, Blitzen, Halfborn Gunderson, Hearthstone, Magnus Chase, Mallory Keen, Samirah al-Abbas, Thomas Jefferson Jr.
Mario: Bowser Jr., Bowser, Luigi, Mario, Princess Daisy, Princess Peach, Rosalina, Toad, Waluigi, Wario, Yoshi
Marvel Comics: Adam Warlock, Agent Venom, Amadeus Cho, America Chavez, Angel, Anole, Armor, Aurora, Banshee, Beast, Bentley-23, Black Panther, Black Widow, Blink, Blue Marvel, Bucky Barnes, Cannonball, Captain America, Captain Britain, Carol Danvers, Cassie Lang, Cloak, Colossus, Cyclops, Dani Moonstar, Danielle Cage, Daredevil, Doc Samson, Doctor Doom, Doctor Strange, Dragon Man, Drax the Destroyer, Eric Matterson, Falcon, Fandral, Firelord, Franklin Richards, Gambit, Gamora, Glob Herman, Groot, Hank Pym, Hawkeye, Hogun, Hope van Dyne, Hulk, Hulkling, Iceman, Iron Fist, Iron Lad, Iron Man, Ironheart, Jane Foster, Janet van Dyne, Jean Gray, Jim Hammond, Karma, Kate Bishop, Kid Omega, Kitty Pryde, Laura Kinney, Loki, Luke Cage, Magik, Magneto, Mantis, Marvel Boy, Miles Morales, Misty Knight, Moondragon, Mr. Fantastic, Ms. Marvel, Nadia van Dyne, Namor the Sub-Mariner, Nebula, Nightcrawler, Nightthrasher, Northstar, Nova, Old Man Logan, Patriot, Phylla Vell, Pip the Troll, Pixie, Prodigy, Psylocke, Puck, Quake, Quasar, Quicksilver, Red Hulk, Richard Rider, Rocket Raccoon, Rockslide, Rogue, Sam Alexander, Sasquatch, Scarlet Witch, Scott Lang, She-Hulk, Silk, Speed, Speedball, Spider-Ham, Spider-Man Noir, Spider-Man, Spider-Punk, Spider-Woman, Star Lord, Storm, Sunfire, Sunspot, Superior Spider-Man, Swarm, The Human Torch, The Invisible Woman, The Silver Surfer, The Thing, Thor, U.S. Agent, Ultron, Valerie Richards, Venom, Vision, Viv Vision, Volstagg, War Machine, Warlocke, Warpath, Wiccan, Wolverine, Young Cyclops
Mass Effect: Ashley Williams, Commander Shepard, EDI, Garrus Vakarian, Grunt, Jack, Jacob Taylor, James Vega, Javik, Kaidan Alenko, Legion, Liara T'Soni, Miranda Lawson, Mordin Solus, Morinth, Samara, Tali'Zorah, Thane Krios, Urdnot Wrex
Maus: Vladek Spiegelman
Mega Man: Mega Man
Metal Gear: Solid Snake
Metro: Artyom
Metroid: Ridley, Samus Aran
Minority Report: Agatha, Danny Witwer, John Anderton, Lamar Burgess
Mirror's Edge: Faith Connors
Mission Impossible: Ethan Hunt, Luther Stickell
Mistborn: Kelsier, Vin
Moana: Gramma Tala, Maui, Moana, Tamatoa
Moby Dick: Captain Ahab, Ishmael, Queequeg
Monk: Adrian Monk, Leland Stottlemeyer, Natalie Teeger, Randy Disher, Sharona Fleming
Mortal Kombat: Erron Black, Raiden, Scorpion, Shang Tsung, Shao Kahn, Sub-Zero
My Little Pony: Friendship is Magic: Applejack, Fluttershy, Pinkie Pie, Rainbow Dash, Rarity, Twilight Sparkle
NieR: Automata: 2B, 9S, A2
Nimona: Lord Ballister Blackheart, Nimona, Sir Ambrosius Goldenloin
Nineteen Eighty-Four: Julia Dixon, Winston Smith
No Country for Old Men: Anton Chigurh, Ed Tom Bell, Llewelyn Moss
Oblivion: Jack Harper Tech 49, Julia Rusakova Harper, Malcolm Beech, Vika Olsen
Odyssey: Circe, Odysseus, Telemachus
Omniscient Reader's Viewpoint: Anna Croft, Jung Heewon, Kim Dokja, Lee Gilyoung, Lee Hyunsung, Lee Jihye, Yoo Joonghyuk, Yoo Sangah
One Piece: Brook, Franky, Jimbei, Monkey D. Luffy, Nami, Nico Robin, Roronoa Zoro, Tony Tony Chopper, Usopp, Vinsmoke Sanji
Overcooked: Onion King
Overwatch: Bastion, Doomfist, Genji, Hanzo, Mei, Sombra, Tracer, Winston
Pac-Man: Pac-Man
Paper Mario: Bobby, Count Bleck, Dimentio, Mr. L, Paper Mario
Percy Jackson: Annabeth Chase, Apollo, Calypso, Coach Gleeson Hedge, Frank Zhang, Grover Underwood, Hazel Levesque, Jason Grace, Leo Valdez, Meg McCaffrey, Nico di Angelo, Percy Jackson, Piper McLean, Rachel Elizabeth Dare, Reyna Avila Ramirez-Arellano, Thalia Grace, Tyson
Person of Interest: Harold Finch, John Reese, Joss Carter, Lionel Fusco, Root, Sameen Shaw
Persona: Chie Satonaka, Futaba Sakura, Haru Okumura, Joker, Kanji Tatsumi, Makoto Niijima, Morgana, Naoto Shirogane, Rise Kujikawa, Ryuji Sakamoto, Yosuke Hanamura, Yu Narukami, Yukiko Amagi, Yusuke Kitagawa
Persona 5: Ann Takamaki
Phineas & Ferb: Baljeet Tjinder, Buford Van Stomm, Candace Flynn, Ferb Fletcher, Heinz Doofenshmirtz, Isabella Garcia-Shapiro, Norm, Perry the Platypus, Phineas Flynn
Pikmin: Olimar
Pokemon: Blue, Brock, Giovanni, James, Jesse, Meowth, Misty, Pikachu, Red (Pokemon)
Pokemon Anime: Ash Ketchum
Predator: Major Alan 'Dutch' Schafer, Quinn McKenna, The Predator
Psycho: Norman Bates
Punch-Out!!: Little Mac
RWBY: Blake Belladonna, Ruby Rose, Weiss Schnee, Yang Xiao Long
Rambo: Colonel Sam Trautman, John Rambo
Raya and the Last Dragon: Boun, Little Noi, Namaari, Ongis, Raya, Sisu, Tong
Ready Player One: Akihide Karatsu, Helen Harris, James Donovan Halliday, Samantha Cook, Wade Owen Watts
Red Faction): Parker
Red Film: Frank Moses, Sarah Ross
Red vs Blue: Dexter Grif, Dick Simmons, Franklin Delano Donut, Lopez the Heavy, Sarge
Saving Private Ryan: Captain John H. Miller, Private James Ryan
Sesame Street: Abby Cadabby, Bert, Big Bird, Cookie Monster, Count von Count, Elmo, Ernie, Grover, Mr. Hooper, Mr. Noodle, Mr. Snuffleupagus, Oscar the Grouch, Sherlock Hemlock
She-Ra and the Princesses of Power: Adora, Bow, Catra, Glimmer
Shortpacked: Amazi-Girl, Ethan Siegal, Galasso, Jeshua Ben Joseph, Leslie Bean, Ronald Reagan, Ultra Car
Slaughterhouse-Five: Billy Pilgrim
Sofia the First: Sofia the First
Sonic: Amy Rose, Big the Cat, Blaze the Cat, Charmy Bee, Cream the Rabbit, Doctor Eggman, Espio the Chameleon, Knuckles the Echidna, Mighty the Armadillo, Rouge the Bat, Shadow the Hedgehog, Silver the Hedgehog, Sonic the Hedgehog, Tails Prower, Vector the Crocodile
Spy Kids: Carmen Cortez, Juni Cortez
Star Fox: Falco Lombardi, Fox McCloud, Peppy Hare, Slippy Toad, Wolf O'Donnell
Star Trek: Chakotay, Cisco, Data, Kira Nariz, LeForge, Michael Burnam, Nelix, Picard, Riker, Scotty, the EMH, Worf
Star Trek: The Original Series: Captain Kirk
Star Wars: Finn, Kit Fisto, Mace Windu, Padme Amidala, Poe Dameron
Star Wars (Original Trilogy): Darth Vader
Star Wars Original Trilogy: C3PO, Chewbacca, Han Solo, Leia Organa, Luke Skywalker, R2-D2
Star Wars Prequel Trilogy: Qui-Gon Jinn
Star Wars Sequel Trilogy: BB-8, Kylo Ren, Rey
Star Wars: The Clone Wars: Anakin Skywalker, Obi-Wan Kenobi, Yoda
Stardew Valley: Abigail, Alex, Grandpa, Krobus, Lewis, Maru, Morris, Mr. Qi, Shane, Willy
Stargate: Daniel Jackson, George Hammond, Jack O'Neill, Samantha Carter, Teal'c
Stranger Things: Dustin Henderson, Eleven, Jim Hopper, Jonathan Byers, Karen Wheeler, Lucas Sinclair, Mike Wheeler, Nancy Wheeler
Street Fighter: Akuma, Chun-Li, Guile, Ken, M. Bison, Ryu, Seth
Suicide Squad: Amanda Waller, Captain Boomerang, Col. Rick Flag, Deadshot, El Diablo, Enchantress, Harley Quinn, Killer Croc
Tacoma: Amy Ferrier
Team Fortress 2: Demoman, Engineer, Heavy, Medic, Pyro, Scout, Sniper, Soldier, Spy
Terraria: The Guide
The Adventures of Sharkboy and Lavagirl in 3-D: Lavagirl, Max, Sharkboy
The Backyardigans: Austin, Pablo, Tasha, Tyrone, Uniqua
The Balance: Dalo Handel, Digrin F'an, Drakes Gor, Jen Stern, Kerril Gadden, Myr-Getakksis, Nina, Ogabith Wisend, Ramses, Vru Arixmethes, Zim Tuzig
The Bee Movie: Barry B. Benson
The Clone Wars: Ahsoka Tano
The Expanse: Chrisjen Avasarala, James Holden, Josephus Miller
The Henry Stickmin Collection: Henry Stickmin
The Hobbit: Bard the Bowman, Bilbo Baggins, Smaug
The Hunger Games: Gale Hawthorne, Katniss Everdeen, Peeta Mellark
The Incredibles: Dash Parr, Elastigirl, Frozone, Jack-Jack Parr, Mr. Incredible, Violet Parr
The Last of Us: Ellie, Joel
The Legend of Korra: Asami Sato, Bolin, Korra, Mako
The Legend of Zelda: Daruk, Darunia, Impa, Link, Mipha, Nabooru, Navi, Revali, Ruto, Saria, Urbosa, Zelda
The Mandalorian: Cara Dune, Kuiil, The Child, The Mandalorian
The Martian: Annie Montrose, Beth Johanssen, Bruce Ng, Commander Melissa Lewis, Dr. Alex Vogel, Dr. Chris Beck, Major Rick Martinez, Mark Watney, Rich Purnell, Teddy Sanders, Vincent Kapoor
The Matrix: Morpheus, Neo, Trinity
The Muppets: Animal, Beaker, Dr. Bunsen Honeydew, Dr. Teeth, Floyd Pepper, Fozzie Bear, Gonzo, Janice, Kermit the Frog, Miss Piggy, Pepe the King Prawn, Rowlf the Dog, Sam Eagle, Scooter, Statler, Swedish Chef, Waldorf, Zoot
The Peanuts Movie: Charlie Brown, Linus, Lucy, Snoopy
The Road: The Boy, The Man
The Witcher: Cirilla Fiona Elen Riannon, Geralt of Rivia
To Kill a Mockingbird: Atticus Finch, Jem Finch, Scout Finch
Total Recall: Carl Hauser, Melina
Tron: Alan Bradley, Kevin Flynn, Lora Baines, Tron, Yori
Twenty Thousand Leagues Under the Sea: Captain Nemo
Twenty Thousand Leagues Under the Seas: Conseil, Ned Land, Professor Pierre Aronnax
Twin Peaks: Dale Cooper, Sheriff Harry S. Truman
Unbroken: IKCFAMWSIIF, Lorana Ritten, Reithen Keiros, Yekkon Shmalakis
Until Dawn: Ashley Brown, Chris Hartley, Emily Davis, Jessica Riley, Josh Washington, Matt Taylor, Mike Munroe, Sam Giddings
Valorant: Breach, Brimstone, Cypher, Jett, Killjoy, Omen, Pheonix, Raze, Reyna, Sage, Sova, Viper
Xenoblade Chronicles: Mythra, Pyra, Rex, Shulk
