2K Games: Amara, Brick
Blizzard Games: Bastion
Bone: Blue Stupid Rat Creature
Capcom: Akuma, Chun-Li, Ryu
Classic Books: Arthur Holmwood, Atticus Finch
Classic Dystopian Books: Alex DeLarge
Classic Fantasy Books: Aragorn
Classic Fantasy Novel: Arya
Classic Fantasy Novels: Arwen, Bard the Bowman, Bilbo Baggins, Boromir, Brom
Classic Films: Alan Bradley
Classic Horror Films: Dr. Loomis, Laurie Strode, Michael Myers
Classic Horror Movies: Alice Johnson
Classic Indie Graphic Novels: Brown Stupid Rat Creature
Classic Modern Books: Anton Chigurh, Arthur Weasley, Bill Weasley
Classic Novels: Captain Ahab, Captain Nemo, Culverton Smith, Inspector Lestrade, James Moriarty, John Watson, Mycroft Holmes, Sherlock Holmes
Classic Sci-Fi Books: Bruce Ng
Classic Sci-Fi Novels: Bean
Classic Young Adult Novels: Brian Robeson
DC: Alan Scott, Alexander Luthor Jr., Alfred Pennyworth, Amanda Waller, Amethyst, Anti-Monitor, Aquaman, Barbara Gordon, Barry Allen, Bart Allen, Batman, Beast Boy, Black Lightning, Booster Gold, Brainiac 5, Captain Boomerang, Captain Marvel Jr., Captain Marvel, Damian Wayne, Dick Grayson, Hal Jordan, Hawkgirl, Irey West, Jai West, Jason Todd, Jesse Quick, John Stewart, Martian Manhunter, Max Mercury, Tim Drake, Wally West II, Wally West, Wonder Woman
Disney: Adam Warlock, Agent Venom, Ahsoka Tano, Amadeus Cho, America Chavez, Anakin Skywalker, Angel, Anna, Anole, Armor, Audrey Ramirez, Aurora, Baljeet Tjinder, Baron Zemo, BB-8, Beast, Bentley-23, Black Panther, Black Widow, Blue Marvel, Boun, Bucky Barnes, Buford Van Stomm, C3PO, Cal Kestis, Candace Flynn, Cannonball, Captain America, Captain Britain, Carol Danvers, Cassie Lang, Chewbacca, Colossus, Cyclops, Darth Vader, Dyan, Grand Moff Tarkin, Luke Skywalker, Maui, Miles Morales, Moana, Monica Rambeau, Mr. Fantastic, Ms. Marvel, Namaari, Nightcrawler, Noi, Pan, Raya, Sam Alexander, Sheev Palpatine, Sisu, Spider-Man, Tamatoa, Te Ka, The Human Torch, The Invisible Woman, The Thing, Tong, Uka, Viv Vision, Wolverine, Yoda, Young Cyclops
DreamWorks Pictures: Captain John H. Miller
Dungeons & Dragons: Akkar, Byllemura Ruby-Eye
Guerrilla Games: Aloy
Horror Video Games: Alan Wake, Ashley Brown, Barry Wheeler
Indie Video Games: Abigail, Alex, Alphys, Asgore, Chara, Elliot, Emily, Flowey, Frisk (Genocide Route), Frisk (Neutral Route), Frisk (Pacifist Route), Haley, Harvey, Leah, Maru, Mettaton EX, Papyrus, Penny, Sam, Sans, Sebastian, Shane, Toriel, Undyne
Jim Henson's Muppets: Abby Cadabby, Animal, Beaker, Bert, Big Bird
Literary Classics: Abraham Van Helsing
Meme Movies: Barry B. Benson
Modern Classic Books: Albus Dumbledore
Modern Mythology: Alex Fierro, Amos Kane, Annabeth Chase, Apollo, Blitzen, Calypso, Carter Kane, Frank Zhang, Halfborn Gunderson, Hazel Levesque, Jason Grace, Leo Valdez, Mallory Keen, Piper McLean, Thomas Jefferson Jr.
Netflix: Adora, Bow
Netflix Originals: Catra
Nickelodeon: Aang, Asami Sato, Azula
Nickelodian: Bolin
Nintendo: Alois, Alucard, Annette, Ash Ketchum, Ashe, Bernadetta, Blue, Bobby, Bowser Jr., Bowser, Brock, Byleth, Captain Falcon, Caspar, Catherine, Claude, Dorothea, Felix, Ferdinand, Ingrid, Linhardt, Petra (Fire Emblem), Red (Pokemon), Sylvain
Physical Games: Araithia Shokta, Arthail Consumer of Food, Arthas Menethil
Rare: Banjo
Real Life: Colin Frazer, Ethan Chou, Harrison Truscott (Evil), Harrison Truscott, Jono Jenkins, Sebastian Polge, Vikram Kommareddi, Zach Wiebe
Real-Life TV Shows: Adrian Monk, Agatha, Allison Blake
Riot Games: Breach, Brimstone
Sega: Amy Rose, Big the Cat, Blaze the Cat
Square Enix Games: Aerith Gainsborough, Barret Wallace
Troublemaker Studios: Carmen Cortez
Valve: Alyx, Demoman, Engineer, Gordon Freeman, Heavy, Medic, Pyro, Scout, Sniper, Soldier, Spy
ViacomCBS: Captain Kirk
Video Games: Artyom
Viking Press: Captain George Pollard Jr.
Warner Bros: Omega (Edge of Tomorrow), Rita Vrataski, William Cage
Webcomics: Ally, Amazi-Girl
Webtoons: Anna Croft
Weekly Shonen Jump: Brook, Caesar Anthonio Zeppeli
YouTube Creators: Extortionist Hobo, LeBron
Young Adult Books: Amy Cahill
Young Adult Novels: Akihide Karatsu, Annie Montrose, Beth Johanssen
id Software: Doom Guy
