Justice League (Core): Barry Allen, Batman, Superman
Justice League (Extended): Aquaman, Barry Allen, Bart Allen, Batman, Black Canary, Black Lightning, Booster Gold, Captain Marvel Jr., Captain Marvel, Green Arrow, Mary Marvel, Supergirl, Superman, Ted Kord, Wally West
Justice League (film): Aquaman, Barry Allen, Batman, Superman
Justice League Founder: Aquaman, Barry Allen
Justice League Unlimited: Batman, Superman, Wally West
Justice League International: Booster Gold, Ted Kord
Justice Society of America (Core): Alan Scott, Jay Garrick
Justice Society of America (Extended): Alan Scott, Jay Garrick, Kal-L
Young Justice (Core): Bart Allen
Young Justice (Extended): Amethyst, Bart Allen, Wally West
Teen Titans (Extended): Bart Allen, Captain Marvel Jr., Supergirl, Wally West
Teen Titans (Core): Beast Boy, Wally West
Teen Titans Founders: Wally West
Teen Titans Go! Cast: Beast Boy
Birds of Prey (Core): Barbara Gordon, Black Canary
Birds of Prey (Extended): Barbara Gordon, Black Canary
Doom Patrol (Extended): Beast Boy
Green Lantern Corps: Alan Scott
Bat-Family (Core): Alfred Pennyworth, Barbara Gordon, Batman
Bat-Family (Extended): Alfred Pennyworth, Barbara Gordon, Batman, Jim Gordon
Legion of Superheroes (Core): Brainiac 5
Survivors of the First Crisis (DC Comics): Alexander Luthor Jr., Kal-L, Superboy Prime
Arrowverse Main Cast: Barry Allen
Outsiders: Batman, Black Lightning
Flash Family: Barry Allen, Bart Allen, Jay Garrick, Wally West
The Rogues (Flash): Captain Boomerang
Shazam Family: Captain Marvel Jr., Captain Marvel, Mary Marvel
Stardew Valley Trio: Abigail
Stardew Valley Bachelorettes: Abigail
Stardew Valley Bachelors: Alex
Stardew Valley Residents: Abigail, Alex
Avengers (Core): Black Panther, Black Widow, Captain America, Hawkeye, Hulk, Iron Man, Janet van Dyne, Spider-Man, Thor, Vision
Avengers (Extended): Agent Venom, Beast, Black Panther, Black Widow, Captain America, Captain Britain, Cassie Lang, Falcon, Hank Pym, Hawkeye, Hulk, Iron Man, Janet van Dyne, Nadia van Dyne, Quicksilver, Scarlet Witch, Scott Lang, Spider-Man, Thor, Vision, War Machine
USAvengers: Cannonball
Guardians of the Galaxy (Extended): Adam Warlock, Agent Venom
Champions (Marvel) (Core): Amadeus Cho, Ironheart, Viv Vision
Young Avengers (Extended): America Chavez, Cassie Lang, Iron Lad
X-Men First Class: Angel, Beast
X-Men (Extended): Angel, Anole, Armor, Aurora, Banshee, Beast, Blink, Cannonball, Magneto, Northstar, Psylocke, Quicksilver, Scarlet Witch, Storm
X-Men (Core): Beast, Psylocke, Storm
Young X-Men: Anole, Armor
Giant Sized X-Men #1 Team: Banshee, Storm
New Mutants (Core): Cannonball
New Mutants (Extended): Cannonball
Excalibur (Marvel): Psylocke
Fantastic Four (Extended): Bentley-23, Black Panther, Spider-Man, Storm
Future Foundation: Bentley-23
Exiles (Core): Blink
Infinity Watch: Adam Warlock
Symbiote Squad: Agent Venom
Hulks: Amadeus Cho, Hulk
Ultimates (Team): America Chavez, Black Panther, Blue Marvel
Alpha Flight: Aurora, Northstar
Falcon & the Winter Soldier Main Trio: Baron Zemo, Bucky Barnes
Invaders: Captain America
Avengers Original Quintet: Captain America, Thor
Band of Fools (Original): Akkar, Arthail Consumer of Food, Byllemura Ruby-Eye, Glynnric Manassnass, Kalathos Sunstrider, Kareem Par-Al, Nahara, Ruby Rider
Band of Fools (Redux): Arthail Consumer of Food, Byllemura Ruby-Eye, Kalathos Sunstrider
Original Three (Band of Fools): Arthail Consumer of Food, Glynnric Manassnass, Kalathos Sunstrider
Zach Wiebe's Permutations: Akkar
Aarav Gupta's Permutations: Arthail Consumer of Food
Harrison Truscott's Permutations: Byllemura Ruby-Eye
Order of the Pheonix I: Albus Dumbledore
Order of the Pheonix II: Albus Dumbledore, Arthur Weasley, Bill Weasley, Fleur Delacour
Hogwarts Professors: Albus Dumbledore
Weasley Family: Arthur Weasley, Bill Weasley, Ginny Weasley, Ron Weasley
The Gaang: Aang, Katara, Sokka, Toph Beifong, Zuko
Avatars: Aang, Korra
Team Avatar (Korra): Asami Sato, Bolin, Korra
Sesame Street Residents: Abby Cadabby, Bert, Big Bird, Ernie
The Muppet Show: Animal, Beaker, Dr. Bunsen Honeydew
Electric Mayhem: Animal
Best Friends Squad: Adora, Bow, Catra, Glimmer
The Rebellion (She-Ra): Adora, Bow, Catra, Glimmer
The Princess Alliance: Adora, Bow, Glimmer
Jedi Order: Ahsoka Tano, Anakin Skywalker, Cal Kestis, Luke Skywalker, Mace Windu, Obi-Wan Kenobi, Qui-Gon Jinn, Yoda
501st Legion (Star Wars): Ahsoka Tano, Anakin Skywalker
Star Wars Droids: BB-8, C3PO, R2-D2
Star Wars Droid Duo: C3PO, R2-D2
Stinger Mantis Crew: Cal Kestis
Sith Lord: Darth Vader
Galactic Empire: Darth Vader
Sequel Trilogy Main Cast: BB-8, Rey
The Clone Wars Primary Trio: Ahsoka Tano, Anakin Skywalker, Obi-Wan Kenobi
Original Trilogy Quintet: C3PO, Chewbacca, Han Solo, Leia Organa, Luke Skywalker, R2-D2
Heroes of Olympus: Annabeth Chase, Leo Valdez, Percy Jackson
Greek Demigods (Rick Riordan): Annabeth Chase, Leo Valdez, Percy Jackson
Original Prophecy: Annabeth Chase, Percy Jackson
Trials of Apollo Crew: Apollo
Titans (Rick Riordan): Calypso
Floor 19: Alex Fierro, Magnus Chase
Norse Demigods (Rick Riordan): Alex Fierro, Blitzen, Magnus Chase
Magnus Chase First Quintet: Blitzen, Hearthstone
Magnus Chase Ragnarok-Halting Gang: Blitzen, Hearthstone
House of Life: Amos Kane, Carter Kane, Sadie Kane, Walt Stone, Zia Rashid
Twenty-First Nome: Amos Kane, Carter Kane, Sadie Kane, Walt Stone, Zia Rashid
Knights of Seiros: Alois, Byleth, Catherine, Flayn, Rhea, Seteth, Shamir
Black Eagles: Bernadetta, Byleth, Edelgard, Hubert
Blue Lions: Annette, Byleth, Dedue, Dimitri, Mercedes
Golden Deer: Byleth, Claude, Hilda
Vault Hunters: Amara, Axton, Brick
Borderlands 1 Vault Hunters: Brick
Borderlands 2 Vault Hunters: Axton
Borderlands 3 Vault Hunters: Amara
Shortpacked! Store: Amazi-Girl
Dumbing of Age Main Cast: Amazi-Girl
Sonic the Hedgehog (Main Cast): Amy Rose, Sonic the Hedgehog
Resistance (Sonic): Amy Rose, Sonic the Hedgehog
Sonic the Hedgehog (Extended Cast): Amy Rose, Big the Cat, Blaze the Cat, Sonic the Hedgehog
NASA (The Martian): Annie Montrose, Bruce Ng
Ares III Mission Crew: Beth Johanssen, Dr. Chris Beck
Fellowship of the Ring: Aragorn, Boromir
Thorin and Company: Bilbo Baggins
Pokemon Anime Kanto Trio: Ash Ketchum, Brock
Champions (Pokemon): Blue, Red (Pokemon)
Kanto Gym Leaders: Blue, Brock
Super Smash Bros: Banjo, Bayonetta, Bowser Jr., Bowser, Captain Falcon, Kazooie, Ken, Luigi, Mario, Princess Daisy, Princess Peach, Rosalina, Ryu
Super Smash Bros DLC: Banjo, Kazooie
Paper Mario: The Origami King Cast: Bobby
Koopa Troopa: Bowser Jr., Bowser
Zeppeli Family: Caesar Anthonio Zeppeli
Battle Tendency Cast: Caesar Anthonio Zeppeli
Flynn-Fletcher Family: Candace Flynn
Phineas and Ferb Main Child Group: Baljeet Tjinder, Buford Van Stomm

Dracula Hunters: Abraham Van Helsing, Arthur Holmwood, John Seward, Jonathan Harker, Mina Harker, Quincey Morris
SFPD (Monk): Adrian Monk
Final Fantasy VII Party: Aerith Gainsborough, Barret Wallace
High Five (Ready Player One): Akihide Karatsu
ENCOM: Alan Bradley
Einharjar (Magnus Chase): Alex Fierro, Magnus Chase
Eureka! Citizens: Allison Blake
Fans! Cast: Ally, Rikk, Rumy
Fans! Polyamorous Group: Ally, Rikk, Rumy
Resistance (Half-Life): Alyx
Suicide Squad (Core): Amanda Waller, Captain Boomerang
Suicide Squad (Extended): Amanda Waller, Captain Boomerang
Kanes: Amos Kane, Carter Kane, Sadie Kane
Phantom Thieves of Hearts: Ann Takamaki
Frozen Quintent: Anna, Elsa, Kristoff, Olaf, Sven
Camp Half-Blood: Annabeth Chase, Apollo, Leo Valdez, Percy Jackson
League of Legends Champions: Aphelios
Friendship Main Squad (My Little Pony): Applejack
Until Dawn Cast: Ashley Brown
Finch Family: Atticus Finch, Jem Finch, Scout Finch
Atlantis Crew (Disney): Audrey Ramirez
The Backyardigans: Austin
Azula's Capture-the-Avatar Gang: Azula, Mai, Ty Lee
Overwatch Heroes: Bastion
The Resistance (Star Wars): BB-8, C3PO, Chewbacca, Leia Organa, R2-D2, Rey
Ender's Jeesh: Bean
Original Four (KSP): Bill Kerman, Bob Kerman
Avengers Original Quintent: Black Widow, Hawkeye, Hulk, Iron Man
SHIELD (Marvel): Black Widow
Team RWBY: Blake Belladonna, Ruby Rose, Weiss Schnee, Yang Xiao Long
Rat Creature Horde (Bone): Blue Stupid Rat Creature, Brown Stupid Rat Creature
Raya and the Last Dragon Crew: Boun
Legion of Superheroes (Extended): Brainiac 5, Supergirl
Valorant Agents: Breach, Brimstone
Straw Hat Pirates: Brook
Captain America Corps: Bucky Barnes, Captain America, Falcon
Rebel Alliance (Star Wars): C3PO, Chewbacca, Han Solo, Leia Organa, Luke Skywalker, Obi-Wan Kenobi, R2-D2
Pequod Crew: Captain Ahab
Big Three (Marvel): Captain America, Iron Man, Thor
Essex Crew: Captain George Pollard Jr.
C Company (Saving Private Ryan): Captain John H. Miller
Star Trek: The Original Series Crew: Captain Kirk
The Nautilus Crew: Captain Nemo
OSS: Carmen Cortez, Juni Cortez
Cortez Family: Carmen Cortez, Juni Cortez
Ant-Man Cast: Cassie Lang, Hank Pym, Hope van Dyne, Janet van Dyne, Nadia van Dyne, Scott Lang
Super Pal Trio: Catra
Interpol: Chun-Li
House Leaders (Fire Emblem): Claude, Dimitri, Edelgard
Children of the Goddess (Fire Emblem): Flayn, Rhea, Seteth
Triwizard Tournament Competitors: Fleur Delacour
Bone Cousins: Fone Bone, Phoney Bone, Smiley Bone
Bone Main Cast: Fone Bone, Gran'ma Ben, Phoney Bone, Smiley Bone, Thorn Harvestar
Dumbledore's Army: Ginny Weasley, Harry Potter, Hermione Granger, Ron Weasley
Gryffindor (Harry Potter's Years): Ginny Weasley, Harry Potter, Hermione Granger, Ron Weasley
Colin Frazer's Permutations: Glynnric Manassnass
Valley Inhabitants (Bone): Gran'ma Ben, Thorn Harvestar
Seven Soldiers of Victory: Green Arrow
Harry Potter Main Trio: Harry Potter, Hermione Granger, Ron Weasley
Thunderbolts: Hawkeye
West Coast Avengers: Hawkeye
Avengers Founders: Hulk, Iron Man, Janet van Dyne, Thor
Young Avengers Founders: Iron Lad
Exiles: Iron Lad, Psylocke
Kang the Conqueror Permutations: Iron Lad
Iron Men Corps: Iron Man, Ironheart, War Machine
Champions (Marvel) (Extended): Ironheart, Viv Vision
GCPD: Jim Gordon
Ethan Chou's Permutations: Kalathos Sunstrider
Ashleigh Smith's Permutations: Kareem Par-Al
Skywalkers (Star Wars): Kylo Ren, Leia Organa, Rey
First Order (Star Wars): Kylo Ren
Sith Lords: Kylo Ren
Death Eaters: Lord Voldemort
Mario Cast: Luigi, Mario, Princess Daisy, Princess Peach
Shadaloo: M. Bison, Seth
Super Smash Bros Original Cast: Mario
Survivors of the Constant: Maxwell
Team Fortress: Medic
Champions (Extended): Nadia van Dyne
Abby Smetana's Permutations: Nahara
Player Characters (Pokemon): Red (Pokemon)
Jack Noland's Permutations: Ruby Rider
Shirai Ryu: Scorpion
Talon: Sombra
Spider-People: Spider-Man
Superman Family: Supergirl, Superman
The Black Order: Thanos
Asgardians (Marvel): Thor
